15 15
40 40

00 00 00 00 00 00 00 00 00 00 00 00 00 00 00
00 02 03 04 00 00 00 00 00 00 00 00 00 00 00
00 00 00 00 00 01 00 00 00 00 00 00 00 00 00
01 01 01 01 01 01 00 00 00 00 00 00 00 00 00
00 00 00 00 00 00 00 00 00 00 00 00 00 00 00
00 00 00 00 00 00 00 00 00 00 00 00 00 00 00
00 00 00 00 00 00 00 00 00 00 00 00 00 00 00
00 00 00 00 00 01 01 01 01 01 00 00 00 00 00
00 00 00 00 00 01 01 01 01 01 00 00 00 00 00
00 00 00 00 00 00 00 00 00 00 00 00 00 00 00
00 00 00 00 00 00 05 06 07 00 00 00 00 00 00
00 00 00 00 00 00 00 00 00 00 00 00 00 00 00
00 00 00 00 00 00 00 00 00 00 00 00 00 00 00
00 00 00 00 00 00 00 00 00 00 00 00 00 00 00
00 00 00 00 00 00 00 00 00 00 00 00 00 00 00
